4 1 1 7 1 1 1 1 7 1 1 1 4 1 0 0
4 2 1 2 1 2 1 2 1 2 1 0 1 2 7 0
1 1 4 1 1 1 1 1 1 1 0 0 0 1 1 1
0 2 1 2 4 2 1 2 1 2 1 2 1 2 1 2
0 0 1 1 1 1 1 1 4 1 1 1 1 1 1 1
4 2 7 2 4 2 7 2 1 2 1 2 1 2 1 2
1 1 1 1 1 0 0 0 0 1 1 1 1 1 1 1
1 2 1 2 1 2 0 2 1 2 1 7 1 2 1 2
1 1 7 1 1 1 1 1 1 1 1 1 1 1 1 4
1 2 1 1 1 2 1 2 1 2 1 2 1 2 1 2
7 1 4 1 7 1 4 1 1 1 1 1 4 1 1 1
7 2 1 2 1 2 1 2 1 2 1 2 1 2 1 7