0 0 0 0 0 0 0 0 0 0 0 0 0 0 0 0
0 0 0 0 0 0 0 0 0 0 0 0 0 0 0 0
0 0 0 7 7 7 7 7 7 7 7 7 7 0 0 0
0 0 0 7 0 0 0 0 0 0 0 0 7 0 0 0
0 0 0 7 0 2 0 0 0 0 2 0 7 0 0 0
0 0 0 7 0 0 0 0 0 0 0 0 7 0 0 0
0 0 0 7 0 0 0 0 0 0 0 0 7 0 0 0
0 0 0 7 0 2 0 0 0 0 2 0 7 0 0 0
0 0 0 7 0 0 0 0 0 0 0 0 7 0 0 0
0 0 0 7 7 7 7 7 7 7 7 7 7 0 0 0
0 0 0 0 0 0 0 0 0 0 0 0 0 0 0 0
0 0 0 0 0 0 0 0 0 0 0 0 0 0 0 0