0 0 0 0 0 0 0 0 0 0 0 0 0 0 0 0
0 0 4 4 0 0 0 0 0 0 0 0 0 0 0 0
0 0 0 4 4 0 0 0 0 0 0 0 0 0 0 0
0 0 0 4 4 0 0 0 0 0 0 4 0 0 0 0
0 0 0 4 0 0 0 0 0 4 4 4 0 0 0 0
0 0 0 0 0 0 0 0 4 4 4 4 0 0 0 0
0 0 0 0 0 0 0 0 0 0 4 4 4 0 0 0
0 0 0 0 0 0 0 0 0 0 0 4 4 0 0 0
0 0 0 0 0 0 0 0 0 0 0 0 0 0 0 0
0 0 7 7 7 7 0 0 4 0 0 0 7 7 0 0
0 0 7 7 7 0 0 0 4 4 0 0 0 7 7 7
0 0 0 0 0 0 0 0 0 0 0 0 0 7 7 7