0 0 0 0 0 7 7 0 0 0 0 0 0 0 4 4
0 0 0 0 0 0 2 0 0 0 0 0 4 0 0 4
0 4 4 0 0 0 2 0 0 0 0 0 4 4 0 0
0 0 7 1 1 7 2 0 0 0 0 0 0 0 0 0
7 2 2 2 2 2 2 0 0 0 0 0 0 0 0 0
0 0 0 0 0 0 0 0 0 0 0 0 0 0 0 0
0 0 0 0 0 0 0 0 0 0 0 0 0 0 0 0
0 0 0 0 0 0 0 0 0 2 2 2 2 2 2 7
0 0 0 0 0 0 0 0 0 2 7 1 1 0 0 7
0 0 0 0 0 0 0 0 0 2 7 0 0 0 0 0
7 0 0 0 0 0 0 0 0 2 0 0 0 0 0 0
7 7 0 0 0 0 0 0 0 7 0 4 4 0 0 0